Dobles
9,9

0,0,1,0,20,250,250
7,0,1,0,50,100,0
4,3,2,0,20,250,250
7,5,2,0,50,100,0

# paredes

1,1,6,0,0,0,0
2,2,6,0,0,0,0
3,3,6,0,0,0,0
4,4,6,0,0,0,0
5,5,6,0,0,0,0
6,6,6,0,0,0,0
1,4,6,0,0,0,0
5,2,6,0,0,0,0
6,2,6,0,0,0,0
1,4,6,0,0,0,0

# trampas
3,5,7,0,0,0,0
5,6,7,0,0,0,0
1,3,7,0,0,0,0

# espejos
3,4,3,3,0,0,0
1,2,4,1,0,0,0
5,7,4,1,0,0,0